####################
#           # #    #
# ## # # ## #   ## #
#  #   # #  # # #  #
#    #    #   #    #
# ## # ## # #  ### #
# #  #      Z#     #
# # #### ### ## # ##
#               #  #
# ## # # ## ## ## ##
#           # #    #
# ## # # ## #   ## #
#  #   # #  # # #  #
#A   #    #   #    #
# ## # ## # #  ### #
# #  #       #     #
# # #### ### ## # ##
#               #  #
####################
