####################
#           # #    #
# ## # # ## #   ## #
#  #   # #  #Z# #  #
#    #    #   #    #
# ##A# ## # #  ### #
# #  #       #     #
# # #### ### ## # ##
#               #  #
####################
