####################
#      #    # #    #
# ## # # ##     ####
#  #   # #  # # #  #
#    #    #   #    #
# #### ## # #  ### Z
#    #    #  #     #
# #A##  #### ## # ##
# #             #  #
####################
