####################
#      #    # #    #
# ## # # ##     ####
#  #   # #  # # #  #
#    #    #   #    #
S #### ## # #  ### E
#    #    #  #     #
# # ##  #### ## # ##
# #             #  #
####################
