########################################
#           # #    #####################
# ## # # ## #   ## #####################
#  #   # #  # # #  #####################
#    #    #   #    #####################
# ## # ## # #  ###          ############
# #  #       #     ######## ############
# # #### ### ## # ######### ############
#   A           #  ######## ############
# ## # # ## ## ## #########            #
#           # #    ######## ########## #
# ## # # ## #   ## ######## ##########Z#
#  #   # #  # # #  ######## ########## #
#    #    #   #    ########            #
# ## # ## # #  ### ######## ############
# #  #       #     ######## ############
# # #### ### ## # ######### ############
#               #           ############
########################################
