####################
#           # #    #
# ## # # ## #   ## #
#  #   # #  # # #  #
#    #    #   #    #
S ## # ## # #  ### #
# #  #       #     #
# # #### ### ## # ##
#               #  E
####################
